10 10
0 0 0 0 0 0 0 0 0 0 
0 0 3 0 0 0 1 0 0 0 
0 0 0 1 1 1 1 1 1 0 
0 0 0 1 0 0 1 2 0 0 
0 0 0 1 0 0 1 0 0 0 
0 0 2 1 0 0 1 0 0 0 
0 1 1 1 0 0 1 1 1 1 
0 0 0 0 0 0 0 0 0 0 
0 0 0 1 1 1 0 0 0 0 
0 0 0 0 0 1 2 0 0 0 
9 9 8 9
1 2 2 2