10 15
0 0 0 0 0 0 0 0 0 0 0 0 0 0 0
0 0 3 0 0 0 0 0 0 0 0 1 0 0 0
0 0 0 1 1 1 1 0 0 0 0 1 2 0 0
0 0 0 1 0 0 0 0 0 0 0 1 0 0 0
0 0 0 1 0 0 0 0 0 0 0 1 0 0 0
0 0 2 1 0 0 0 0 0 0 0 1 0 0 0
0 1 1 1 0 0 0 1 1 1 1 1 1 0 0 
0 0 0 0 0 1 0 0 0 0 0 1 2 0 0
0 0 0 0 0 1 0 0 0 0 0 0 0 0 0
0 0 0 0 0 1 0 0 0 0 0 0 0 0 0
1 2 3 5
9 10 4 6